dimensions:
WIDTH           100
HEIGHT          100
SCROLL_TIME     4
$end

tiles:
A              	1star1.png 
B              	1star2.png
C              	1star3.png
D 				1star4.png
E 				1star5.png
$end

layout:
ACDEBACB
CDEEBABD
ADBEECAA
ADBBEAED
DBCDCACE
DECDDADB
BAEAECBB
ECEDAEBC
BAABADDB
BBBCCDEA
ADBCAABC
CBDCAACB
DEACBDDE
BEDBDDBC
DECBBBEC
DEBBEECD
BBADDBEA
BEDAEBDB
EBEEACDA
DABBCCCB
DADDDBCB
CBBBEAEB
EDEBDAED
BCDBCEAB
BBBEBCAD
DDAEDCED
DCCCCDEA
CBABBCEC
BCDBDDEA
BEEDDCBA
DAEECDCD
BDCEEEDE
DBBDCCBA
DACACEED
DBCCADDC
BACBCECB
BCCDAEDE
DACBBCEE
EECEDAAD
CCDBDEEB
DBDBADDA
EDAEBCAE
DCBAABCD
ABDBDBED
CACCAEBE
EBEAEABA
ABDCCDDD
EAEADCDE
ACECEACB
ACBCDDAC
CCECDEBD
DABDABBD
CCADDDAB
EBCBEDDC
EBABAAAE
ABBDBDEE
EABCDECB
DACCCADE
EDABBEBB
CCCAACED
DEDEBCCB
CAAEECBD
DDADCACA
DEDBACEC
CBDDADDC
BCCBBEDB
ACEEECDD
EAACEBBB
EBEDDECB
DECEECEE
ACAECCAC
AABBBDCE
DBDAACCB
CAAACEDE
DECCDEEA
ECACCDDC
BDCBAAAD
CCEAAABC
EDEDBBAA
CBAEDCAC
DDBBDDBC
EBECCCBA
ECBDADAE
BDDBCBDB
DCEDDCAE
DBDBBEDA
ABEAEDCB
BBCBCABA
DCDECCCC
AACECDEE
ACDDEAAA
EEDBCABB
CAACEDCC
AEEEAECA
DDEEBABB
BCDCDCAA
AAAECCDC
DADCBBEA
BBDDEBAC
CEACBABE
DDBAEABB
DADCAEAC
DCDDDECD
AEACDACA
EDBEAEAC
BBDDACCA
BBDDDEEE
CABABABA
ECDBEDCE
ACEAECDC
EDEDABCA
CEDACBBD
CEBECDDB
BDBEDEDC
BDCECABD
BCBBBDEB
CECDADAD
ECACAEDE
ACECBEED
CCBCDACB
AECDDDBE
EECABBEA
EADBABCE
ABBEAAAC
DDAEABAE
ADEBDABB
BBAEAEED
DDEBDCBE
CEAEEECC
BBAACCDB
CCDADBDE
BBCBACBD
BEEECACB
CAAADAAB
ABDDADDE
EBADCAED
CDBBCADC
BCBEEBDB
DDBEDEBA
ADCEABBB
ACEBDCEC
DEAEADDD
EABEDBEB
CCDDBBED
BDBADEDE
EAACEDDC
DCCDEAEB
EBCCEEEB
ACDDBAEC
ADEADACA
CBEEDCBE
EAABABEE
DEBBCDDE
CEBEDAED
CBBCBCAE
EBADBEEA
CCBCACCE
DBEBCBCB
DACCDEAD
DEDABEED
DBCDAECE
DBAABCCB
DBBDBCDC
DEAACCAC
BDEECBAC
AEBCECBB
CABEBEBE
DCCCEACB
CACBBEEE
BCDBAABC
EDEEDCAC
BCADAEBD
DDBDACAC
DECCACAD
DBEABDEA
ADDCBBCA
EEABDBBA
BBBBEDAC
BBDBDBCB
DAEAEECE
CEADDCBC
DBECABDA
DEEDDBDE
ACDDCCBB
AEBEDDCE
CDEDEAEC
BDDEDABD
EEDBDBBA
BCDBEECA
ECDDDDCA
AACCEEEA
DBECBCAA
EDCAEACE
BAAADBCB
EECBACAA
ADBCBCEC
EDADBEDD
EABECBAB
ABBACACE
CACCCEDC
$end
