dimensions:
WIDTH           100
HEIGHT          100
SCROLL_TIME     4
$end

tiles:
R               1lava.png
G               1concrete.png
B               1stone.png
$end

layout:
GGGGGGGG
GGGGGGGG
GGGGGGGG
GGGGGGGG
GGGGGGGG
GGGGGGGG
GGGGGGGG
GGGGGGGG
GGGGGGGG
GGGGGGGG
GGGGGGGG
GGGGGGGG
GGGBBGGG
GGBGGBGG
GGBGGBGG
GBBBBBBG
GBGGGGBG
BGGGGGGB
BGGGGGGB
GBBBBGGG
GBGGGBGG
GBGGGGBG
GBGGGGBG
GBGGGGBG
GBGGGBGG
GBBBBGGG
GGGGGGGG
RRRRRRRR
GGRRRRGG
RRRRRRRR
RRRRRRRR
RRRRRRRR
RRRRRRRR
RRGGGGRR
GGRRRRGG
BRBRBRBR
GRGRGRGR
BGBGBGBG
RGBRGBRG
BGRBGRBG
RBGRBGRB
BGRBGRBB
BRBRBRBR
GRGRGRGR
BGBGRGRG
$end
